********************
********************
********************
***##############***
***#************#***
***#*####**####*#***
***#*#********#*#***
***#*#*######*#*#***
***#*#*#****#*#*#***
***#*#*#****#*#*#***
***#*#*#****#*#*#***
***#*#*#****#*#*#***
***#*#*##**##*#*#***
***#*#********#*#***
***#*##########*#***
***#************#***
***######**######***
********************
********************
********************